********************
*-----------c------*
*-*********-*------*
*----ccc----*------*
*-----------*------*
******c******------*
*------*----*------*
*-***--*--*-*------*
*--c*--c--*-c------*
*-***--*--*-*------*
*------*----*------*
******c******------*
*-----------*--i---*
*---ccccc--**------*
*----------*c------*
********************
+