**********
*-i------*
*--------*
*---*----*
*--------*
*--------*
*-----*--*
*--------*
*---c----*
**********
+