**********
*--------*
*------c-*
*---*----*
*-****---*
*--------*
*--*****-*
*---*----*
*------i-*
**********
+