********************
*-----c------------*
*-*--******---*--c**
*------------------*
*------------c-----*
*---*c---*---------*
*---*----*****-----*
*---*------c-------*
*---*---------*----*
*---*******--------*
*----c-----------c-*
*------------------*
**--******--c------*
*-----i--*---------*
*--------*---c-----*
********************
+