**********
*-*-*--*-*
*---*----*
*---*----*
*---*----*
*---*----*
*---*-*--*
*---*----*
*-i-*----*
**********
+